#1rnghatspongebobforsale	Clean
$transen	Clean
-= abbi secraa	Adult
-= adriana chechik	Adult
.comxx	Clean
032114_802 uncen	Clean
100cm flatchested silicone sex doll	Adult
1080p porn	Adult
165 pounded 5'1	Mature
18 abrina fuck	Adult
18 pussy	Adult
18+sex education games	Adult
18035252brazil	Clean
19 year old davon graye	Clean
1910 nude cutie	Adult
1970's bondage photos	Adult
1980's barely legal porn	Adult
1980's nude	Adult
1wqwewqweqwwwrqqww1d ass	Clean
2 cougars and delievery boy	Adult
2 massage girls and a fuck	Adult
2 mature crossdressers having sex	Adult
2017-03-07-6531431 porn	Adult
"2460"":""989;?78+/6/ (4=&!2xxx"	Clean
2girls pissing in office	Adult
35 year old white black man	Clean
3d man summer hot	Clean
3d men with big family	Mature
3d milf hentai	Adult
40yr old bitch legs spreaded fucking	Adult
4590 progue monet	Clean
50 year old sexy blonde sex video	Adult
50's thick nude women	Adult
53 yo milf	Adult
60 year old boobs	Adult
70s nude hairy girls	Adult
787 flight attendant fucked	Adult
80s women in bikinisin sexys movtes	Racy
=+shitbrix.[cum]	Racy
a cartoon of xxx tention	Adult
a matures first big cock	Adult
a shemale gets a blowjob	Adult
a worm geting by a bred gif	Clean
aang and azula hentai	Adult
abby brooke	Clean
abby rode fitness	Adult
abby winters anal	Adult
abella licks ass	Adult
abigail spencer sex scenes	Adult
absol porn	Adult
actress tv big breast	Adult
actresses naked	Adult
addams family porn	Adult
adlteas peeing in dipers	Mature
adria rea handjob	Adult
adriana chechik fans	Adult
adriananedea	Clean
adrienne adult ado	Adult
adult anime coloring book	Adult
adult baby girl	Mature
adult baby punishments	Adult
adult bobs	Clean
adult entertainment in sarasota	Adult
adult kissing naked	Adult
adult lili	Adult
adult lounges dc	Adult
adult movie	Adult
adult nude brunetts bending over gif	Adult
adult pan	Mature
adult serach	Adult
adult snacks	Clean
adult store in san diego	Adult
adult toy store chesepeake	Adult
adult toys in panorama city	Adult
adult toys in the heights	Adult
adult video bbc hot wife	Adult
adult video store dallas tx	Adult
adult watcherweb.com	Adult
adult.toronto	Adult
adultffriendfinder	Adult
aethercomm 16 wat lda	Clean
africa movies lesbains family	Adult
african man begs for his life	Clean
african teembootypussy	Adult
african tribal lesbians	Mature
africans afternoon ado	Mature
after work masturbation	Adult
agatha adorned ado	Mature
aged adultery ageing	Adult
aggressive handjobs	Adult
ahand licking	Mature
ahhhhh fucking hoars	Racy
aidra fox hd	Adult
ailsa marshall naked pics	Adult
ainme boobs	Adult
airplane boob	Adult
aisne dane booty	Adult
alana li	Adult
alana thomas porn	Adult
alanah swaney	Mature
